







											/\ /\  /\      
											| V  \/  \---. 
											 \_        /   
											  (o)(o)  <__. 
											 _C         /  
											/____,   )  \  
											  \     /----' 
											   ooooo       
											  /     \

